%%%%%%%%%%%%%%%%%%%%%%%%%%%%%%%%%%%%%%%%%%%%%%%%%%
%.%.%        %..  .  ..%  .                     4%
%     %%%%%% %%%%%% %%%% %%  %%%%%%%   %%%% %%%%2%
% %.%.  . .          ..%                   .     %
% . %%%%%%%%%%%%%%%% %%%  %%%%%% %%%%%%%%%%.%%%%%%
%% %%. .   %        .%      % .    . ..   % %   .%
%  .%.%..%   %.%.%.%  .% .%   % .    .%.%    .%  %
% %%%%%%%%%%%%%%%%%%%%%%  %%%%%%%%%%%%%%%%%%%%%% %
%  %.    %.%.    . %   %. %.  %.%.%.%   %..%.%.  %
%.   % %   .. .    . %      %.        %   . .%% %%
%%%%%%.%%%%%%%%%% %%%%%%  %%% %%%%%%%%%%%%%%%% . %
%     .                   %..          . .  .%.% %
%1%%%% %%%%   %%%%%%%  %% %%%% %%%%%% %%%%%%     %
%3                     .  %..  .  ..%        %.%.%
%%%%%%%%%%%%%%%%%%%%%%%%%%%%%%%%%%%%%%%%%%%%%%%%%%
